# 1. 이다 To be
한국 사람입니다	(я) кореец (утв. веж. офиц.)
한국 사람입니까?	(вы) кореец? (вопрос. веж. офиц.)
무엇입니까?	(это) что?  (веж. офиц.)
한국 사람이에요?	(вы) кореец? (веж. неофиц.)
의자예요	(это) стул (веж. неофиц.)
한국 사람이야?	кореец? (панмаль, после согл.)
의자야	стул (панмаль, после гласных)

# 2. 있다 to exist/ be, to have
개가 의자 위에 있어요	Собака (находится) на стуле
나는 언니가 있어요	У меня есть ст. сестра (от жен. лица)

# 4. DoW and days
몇 년	Какой год
몇 월	Какой месяц (кит.-кор)
며칠	Какой день месяца
무슨 요일	Какой день недели

# 1. Verb/ Adj + ㅂ니다/습니다: The present tense of the formal polite style in Korean 
갑니다	иду (веж. офиц.)
좋습니다	хорошо (веж. офиц)
엽니다	открываю (веж. офиц)

# 2. Verb/ Adj + 아/어요 настоящее время, неформ офиц стиль. Деепр. форма
앉아요	сижу (веж. неофиц.)
봐	смотрю (веж. неофиц.)
먹어요	ем (веж. неофиц.)
가	иди (веж. неофиц.)
서요	стою (веж. неофиц.)
보내요	посылаю (веж. неофиц.)
배워요	изучаю (веж. неофиц.)
마셔요	пью (веж. неофиц.)
켜요	включаю (веж. неофиц.)
하여	делаю (веж. неофиц.)
말해요	говорю (слияние) (веж. неофиц.)
돼요	становится (веж. неофиц.)

# V-(으)ㄹ 거예요 ① The Future Tense 
2년 후에 차를 살 거예요	через 2 года куплю машину
중국에서 살았었어요	жил в Китае

# V-고 있다 ① Progressive Tense
민우 씨가 지금 집에 가고 있어요	Мину сейчас идет домой

# Глаголы с отриц. смыслом
한국 사람이 아니에요	не кореец
한국말을 몰라요	не знаю корейского
돈이 없어요	нет денег

# Negative Expressions - 안/못
밥을 안 먹어요	не ем (краткая)
밥을 먹지 않아요	не ем
안 불편해요	не неудобно (краткая)
불편지 않아요	не неудобно
술을 못 마셔요	не пью алкоголь (краткая)
술을 마시지 못해요	не пью алкоголь
저는 수영을 못해요	не умею плавать (краткая)
저는 수영하지 못해요	не умею плавать

# N이/가 Particle 
날씨가 종아요	погода хорошая
과일이 너무 비싸요	фрукты очень дорогие

# N은/는 Particle 
도서관은 지수와 내가 처음 만난 장소이다	Библиотека - место, где впервые я встретил Джису
동생은 부산에 살고 나는 서울에 살고 있다	Мл. брат живет в Пусане, а я - в Сеуле

# N을/를 - The object particle 을/를
아침에는 빵을 먹는다.	По утрам ем хлеб
쓰다 남은 물은 화분을 줘요	Остаток воды вылил в горшок
채소를 사러 시장을 가야 한다	
지난 달 사건을 시작으로 비슷한 범죄가 늘고 있어요	Начиная со случай в прошлом месяце, число похожих преступлений увеличилось 
몸살이 나서 열 시간을 누워 있었다	Устал, провалялся 10 часов
승규는 잃어버린 열쇠를 아직도 찾지를 못했다	Сынгю все никак не находит потерянный ключ

# N와/과 N하고 N(이)랑
미국은 우리나라와 달리 6월에 졸업식을 한다.	В США в отличии от нашей Кореи выпускные отличаются на 6 месяцев
나는 친구와 수영을 배우기로 했다	Я решил учиться плаванию вместе с другом
준하는 어느덧 아버지하고 키가 비슷해졌다.	Джуна неожиданно одного роста с отцом
승규는 게임을 하다 동생하고 크게 다투었다	Сынгю играл в игру и повздорил с мл. братом
내 모자는 네 모자랑 사이즈가 같다	Моя шляпа с твоей шляпой одного размера
나는 친구랑 일찍 헤어지고 집으로 왔다	Я уже расстался с другом и пришел домой.

# N의 particle
친구의 가방	Сумка друга
비둘기는 평화의 상징이다	Голубь - символ мира
하루의 대부분을 학교에서 보낸다	Большую часть дня провожу в школе
부모로서의 역할은 바다에서의 등대와 같다	Роль родителей как маяк в море.

# N에 ① место, время, направление, критерий, слабая причина
문에 서 있다	Стоять в двери.
싸움터에 나가다	Идти на фронт
우호 1시에	В 1ч.
일요일에	В воскресенье.
3년후에	через 3 года
7월 2일 아침에	Утром 2-го июля.
이 잡지는 1년에 4번 발행된다	Журнал издается 4 раз за год.
사과는 5개에 2000원이었다 	5 яблок за 2000 вон.
건강에 좋다	хорошо для здоровья.
질문에 대답하다	Ответить на вопрос.
값은 크기에 따라 다르다	Цена разнится по размеру.
더위에 시달리다	Страдать от жары.

# N에서 
슈퍼마켓에서 산 쇠고기	Говядина, купленная в супермаркете.
그는 부산에서  왔다	He is from Pusan.
기차에서 내리다	Сойти с поезда.
해는 동쪽에서 뜬다 	Солнце встает на востоке.
5에서 3을 빼다	subtract 3 from 5.
그는 호기심에서  방안을 들여다보았다	Он заглянул в комнату из любопытства.
교육적 견지에서	С точки зрения образования.

# N까지
2월 말까지	до конца февраля
최근 노트북 컴퓨터는 가볍고 얇아진 데다 성능까지 좋아졌다	Сегодняшние ноутбуки легкие, тонкие, и даже функции хорошие
유민이는 그렇게 자세하게까지 말하고 싶지는 않았다	Не хочу, ЮминИ настолько подробно говорила
서울에서 부산까지	от Сеула до Пусана.
나는 오늘 일본어로 일부터 십까지 세는 법을 배웠다

# N한테
나는 아들∼ 책을 주었다	Я купил книгу сыну.
그∼ 의지하지 마라	Не надейся на него
나는 그∼ 속았다	Я был обманут им.
나에게 공부할 시간만 더 있었다면 시험을 더 잘 봤을 텐데	Было бы у меня время для занятий, сдал бы экзамен лучше
누구한테 편지를 써요?	Кому пишешь письмо?

# N도
나도 그를 알고 있다	I know him, too. 
그것은 이득도 해악도 되지 않는다	It does neither good nor harm.
그는 프랑스어를 읽지도 쓰지도 말하지도 못한다	He cannot read, write, or speak French.
그녀는 똑똑하기도 하고 친절하기도 하다	She is as kind as she is wise
한 사람∼ 그를 구해 주려고 하는 사람이 없었다	Not a single person made a move to help him.
적어도, 많아도	по меньшей мере, по большому

# N만 N밖에
너만이 이것을 할 수 있다	You are the only one who] can do this
냉장고에 우유밖에 없어요	В холодильнике только молоко
영어∼ 이야기하다	говорить на английском.
내 시계∼ 3시	three o'clock by my watch.
나무∼ 만든 상자	a box made of wood.
교회∼ 들어오다	enter[come into] the church.
내일∼ 원서 접수가 마감된다	The deadline for applications is tomorrow.
우리말을 영어∼ 번역하다	Перевести корейский на английский
그는 과로∼ 병이 났다	Он заболел от переработки.

# (이)나 и другие
아침에 빵이나 밥을 먹어요.	По утром ем хлеб или рис
친구를 두 시간이나 기다렸어요.	Ждал друга часа 2
파티에 20명쯤 왔어요.	На вечеринку пришло около 20 человек
가수처럼 노래를 잘 불러요	Поет хорошо, словно певец.
하영 씨는 천사같이 착해요	Хаён добра словно ангел
비행기가 기차보다 빨라요	Самоле быстрее поезда.
웨슬리 씨는 일요일마다 교회에 가요	Уэсли ходит каждое воскресенье в церковь.

# перечисление и контраст
캐럴 씨는 키가 크고 날씬해요	Кэрол высокая и стройная
아침에 빵을 먹거나 우유를 마셔요	На завтрак ем хлеб или пью молоко
한국말은 어렵지만 재미있어요	Корейский трудной, но интересный
낮에는 차가 많은데 밤에는 차가 없어요	Днем машин много, но ночью машин нет

# 5. Время
2년 전에 한국에 왔습니다	2 года назад приехал в Корею
수영하기 전에 준비운동을 해요	перед плаванием разминаюсь
한 달 후에 아기가 태어나요	через месяц родится ребенок
밥을 먹은 후에 이를 닦아요	поев, почищу зубы
일을 하고 나서 쉽니다	сделал дело, отдыхаю (веж)
바나나를 까서 먹었어요	почистил банан и съел
방학 때 아르바이트를 해요	во время каникул подрабатывал
시험 볼 때 옆 사람의 시험지를 보지 마세요	во время экзамена не смотрите в бумаги соседа
밥을 먹으면서 TV를 봅니다	в время еды смотрю ТВ
지하철 공사 중 입니다	метро в процессе постройки
지금 집에 가는 중이에요	сейчас иду домой
너무 피곤해서 집에 오자마자 잤어요.	очень устал, пришел домой, тут же заснул
어제 4시간 동안 공부했어요.	вчера 4 часа учился
친구들이 점심을 먹는 동안 나는 숙제를 했어요	когда друзья ели, я делал д/з
저는 힌국에 온 지 2년이 되었습니다.	Стало 2 года, как я приехал в Корею

# 6. Возможность и способность
영어를 말할 수 있는 사람	Тот, кто может говорит по-английски
이 시계는 고칠 수가 없다 	Эти часы невозможно починить
그는 하는 수 없이 떠났다	Вынужден был уйти
각도를 잴 줄 알아요	Знаю, как измерять углы
김밥을 만들 줄 몰라요	Не знаю, как делать кимбап

# 7. Требования, просьба
여기 앉으세요. 	Please sit here.
책 15쪽을 보세요. 	Please see (look at) page 15 in the book.
오래 사세요	Живите долго
전화하지 마세요. 	Не звоните
여자 친구 생일이라서 선물을사야 돼요	У подруги д/р, нужно купить подарок
먹기 전에 돈을 내야 해요	Перед едой нужно заплатить
8월은 휴가철이니까 비행기 표를 미리 사지 않으면 안 돼요	
내일은 휴가라서 회사에 가지 않아도 돼요.	

# 8. Надежда
한국말을 잘하고 싶어요.	Хочу говорит по-корейский
에릭 씨는 자동차를 사고 싶어해요	Эрик хочет купить авто
30살 전에 결혼했으면 좋겠어요.	Хотелось бы жениться до 30

# 9. Причина
그 옷은작아서 못 입어요	Эта одежда мала, не надеть
길이 막히니까 지하철을 탑시다.	Дороги забиты, поедем на метро
눈 때문에 길이 미끄러워요.	Из-за снега дороги мокрые
가고 싶지만 아르바이트를 하기 때문에 못 가요.	Хочу пойти, но работую, пойти не могу

# 10. Просьба и помощь
문 좀 닫아 주세요.	Закройте окно
사진 좀 찍어 주시겠어요?	Сделайте фото (для меня)
제가도와 드릴게요.	Позволь помочь тебе
우산이 두 개 있는데 빌려 줄까요?	Здесь 2 зонта, отдолжить вам?

# 11. Новый опыт
아/어 보다  갈비를 먹어 봤어요?	Have you tried Korean ribs?
인도 영화를 본 적이 있어요.	I've seen an Indian movie.
회사에 지각한 적이 없어요.	I've never been late to work.

# 12. Мнение и предложение
같이 농구할까요? 	Поиграем в баскетбол
창문을열까요?	Мне открыть окно?
한식을 먹읍시다. 	Давай поедим корейской еды
도넛 좀 드시겠어요?	Будете (есть) пончик?
등산 같이 갈래요?	Do you want to go hiking?

# 13. Намерения и планы
제가 출장을 가겠습니다.	Поеду в командировку
내일은 비가 오겠습니다. 	Завтра будет дождь
일이 있어서 먼저 갈게요. 	I have work to do, so I’ll be leaving now.
커피 마실래요.	Буду (хочу) кофе.

# 14. Контекст и объяснение
추운데 창문을 닫을까요?	холодно, я закрою окно?
아침에 일어나니까 선물이 있었어요. 	Утро, проснувшись, был подарок.

# 15. Purpose and Intention
옷을 사러 동대문 시장에 가요.	Идем на Тондемун купить одежду.
살을 빼려고 매일 세 시간씩 운동을 해요.	Чтобы похудеть, упражняюсь 3 часа каждый день.
여름휴가 때 여행을 하려고 해요.	Планирую в летний отпуск поехать в путешествие.
건강을 위해서 매일 비타민을 먹고 있습니다. 	Для здоровья принимаю витамины каждый день.
훌륭한 스케이트 선수가 되기 위해 열심히 연습을 합니다. 	Практикуюсь, чтобы стать великим конькобежцем.
우리는 3년 후에 결혼하 기로 했습니다.	Решили пожениться через 3 года.

# 16. Условие
컴퓨터를 많이 하면 눈이 아파요. 	Если используешь много компьютер, то болят глаза.
농구를 잘하려면 점프를 잘해야 돼요. 	Хочешь играть в баскетбол хорошо, нужно умень хорошо прыгать.
크게 말해도 할머니가 못 들어요. 	Даже если говорить громче, бабушка не услышит.

# 17. Предположение
와, 맛있겠어요. 	Ух, выглядит вкусным.
그 옷을 입으면 더울 거예요. 	В этой одежде будет жарко.
주말에 날씨가 더울까요? 	Думаешь, на выходных будет жарко?
어제 비가 온 것 같아요. 	Похоже, вчера шел дождь.

# 18. Изменение части речи
예쁜 가방을 사고 싶어요.	Хочу купить красивую сумку
소파에서 자는 사람이 누구예요?	Спящий на диване - кто?
오늘 저녁에먹을 한국 음식이 뭐예요? 	Сегодня вечером какая еда, что будем есть?
한국말을 공부하기 가 어려워요.	Учит корейский трудно
머리를 짧게 잘랐어요.	Постригла коротко волосы
아이들이 배고파해요	Дети проголодались

# 19. Состояние
치마를 입고 있어요. 	Ношу юбку.
풍선이커졌어요.	Шар стал больше
요리를 잘하게 되었어요. 	Стал хорошо готовить.

# 20. Подтверждение инф-и
명동에 어떻게 가는지 알아요?	Как пройти на Мёндон
저 분이 누구인지 모르겠어요	Не знаю, кто этот человек
내일 날씨가 좋은지 나쁜지 알아요	Знаю, завтра погода хорошая или плохая
운전을 배우는 데 두 달 걸렸어요.	Научиться водить заняло 2 месяца.
차를 고치는 데 30만 원 들었어요.	Починить машину заняло 300 тыс вон
중국 사람이지요? 	Ты - китаец?

# 21. Открытие и удивление
아이스크림을 좋아하는군요.	ты действительно любишь мороженное
벌써 여름이네요.	Действительно уже лето.

# 22. Доп-е окончания
출발할 건가요?	отправляемся?
시간이 있나요?	есть время?
저는 재미있는데요!	интересно

# 23.1 Цитирование
준호 씨가 벨을 누르니까 “딩동”하고 소리가 났어요. 	Джун-О нажала на звонок и раздалось "динь-дон"
민우 씨는 "운동하세요."라고 (말)했어요	
하영 씨가 저에게 사랑한다고 그랬어요.	Хаён сказала мне, что любит
뉴욕이라고 말했어요.	Сказал, что Нью-Йорк
민우 씨는 내일 산에 가지 말자고 했어요. 	Minu said we shouldn't go to the mountain tomorrow.
왕징 씨가 자기한테 말하라고 했어요. 	Ван Джин сказал, чтобы рассказал мне.
?	?
?	?

# 23.2 Сокращенные формы
재미있대요	сказал, интересное
전화하래요	сказал, позвони
테니스를 치재요	поиграем в теннис
뭐 먹고 싶냬요	что хочешь поесть?

# 24. Неправильные глаголы
바빠요	занят
슬퍼요	грустно
꺼 주세요	включи, пожалуйста
열어	открываю (веж. неофиц.)
엽니다	окрываю (веж. офиц)
여세요	откройте, пжл
알려고	дать знать и 
열라	открой
추워	холодно
매운	перченый
쉬우면	если легкий
도와	помогая
걸어	идя пешком
빨라	быстрый (деепр)
불러	зовя
노래	желтый
노라면	если желтый
나아	быть лучше
저어	перемешивать
저으면	если перемешивать
저은	перемешенный